11111
10GE1
1C001
1P001
11111
