11111111111111111111
1P000000000000000001
10000000000C00000001
10000001010101000001
10000111010101111001
100000000101G0000001
10000111110111110001
10000000000000000001
10000111110111110001
1E000000010100000001
10001111010101111001
10000001010101000001
10000001010101000001
10000000000000000001
1000000000000000C001
11111111111111111111
