11111111111111111111111111111111
1P000000000000000000000000000001
10000000000C00000000000000000001
10000001010101000000000000000001
10000111010101111000000000000001
100000000101G0000000000000000001
10000111110111110000000000000001
10000000000000000000000000000001
10000111110111110000000000000001
1E000000010100000000000000000001
10001111010101111000000000000001
10000001010101000000000000000001
10000001010101000000000000000001
10000000000000000000000000000001
1000000000000000C000000000000001
11111111111111111111111111111111
