111111111111111111111111
1P0000000000000000000001
10000000000C000000000001
100000010101010000000001
100001110101011110000001
100000000101G00000000001
100001111101111100000001
100000000000000000000001
100001111101111100000001
1E0000000101000000000001
100011110101011110000001
100000010101010000000001
100000010101010000000001
100000000000000000000001
1000000000000000C0000001
111111111111111111111111
