1111111111
10000C0001
1000111001
10001E1001
1000111001
100000P001
1111111111
