11111111111111111111111111111111
1PCE0000000000000000000000000001
10000000000000000000000000000001
10000000000000000000000000000001
10000000000000000000000000000001
10011111001110111000011111000001
10010001000100100100010001000001
10011111000100100100011111000001
10010010000100100100010001000001
10010001001110111000010001000001
10000000000000000000000000000001
10000000000000000000000000000001
10000000000000000000000000000001
1C000000000000000000000000000001
10000000C00000000000000000000001
10000000000000000000000000000001
10000000000000000000000000000001
10000000000000000000000000000001
10000000000000000000000000000001
11111111111111111111111111111111
