11111111111111111111111111111111
1P000000000000000000000000000001
10000000000000000000000000000001
10000000000000000000000000000001
10000000000000000000000000000001
10000000000000000000000000000001
10000000000000000000000000000001
10000000000000000000000000000001
10000000000000000000000000000001
10000000000000000000000000000001
10000000000000000000000000000001
10000000000011111111111111111111
10000000000000000000000000000001
10000000000000000000001111010001
10000000000000000000001C00010001
10000000000000000000001111111101
10000000000000000000001000000001
10000000000000000000001011111111
100000000000000000000010000000E1
11111111111111111111111111111111
