111111111111
1PC00C0000E1
100000000001
100000000001
100000000001
100000000001
100000000001
100000000G01
111111111111
