1111111111111
100100C0000C1
1C000111110G1
1PG011E000001
1111111111111
