1111111111111111111111111111111111
1E0000000000000C00000C000C00000GC1
1010010100100000101001000000010101
1010010010101010001001000000010101
100000000C00C000000P000001000G0001
1111111111111111111111111111111111
