1111111111111111111111111
1EP0000000000001GCG0001G1
11111110000C0001G000001C1
1000000000000001C0G000101
1000010010011111111110001
1C0001GC1001G000C00G10111
1000010010000000000010001
1G0000000G00000G000000001
1111111111111111111111111
