111111111111111111111111111111111111111
1G0000000000000000111111111111111111111
111111111111111110111111111111111111111
1G0000000000111110111111111111111111111
111111111110111110111111111111111111111
1G0000111110111110111111111111111111111
111110111110111110111111111111111111111
111110111110111110111111111111111111111
111110111110111110111111111111111111111
1G0G0PCCCCCCCCCCCCCCCCCCCCCCCCCCCCCCCE1
110111110111110111111111111111111111111
1G0111110111110111111111111111111111111
111111110111110111111111111111111111111
1G0000000111110111111111111111111111111
111111111111110111111111111111111111111
1G0000000000000111111111111111111111111
111111111111111111111111111111111111111
111111111111111111111111111111111111111
111111111111111111111111111111111111111
111111111111111111111111111111111111111
111111111111111111111111111111111111111
111111111111111111111111111111111111111
