111111
1P0CE1
111111
111111
1000G1
111111
