11111111111111
10P0C0E1111111
10000000000001
10000000000001
10000000000001
10000000000000
11111111111111
