1111111111111111111111111111
1000C100000000000000001C0001
1011110111111111111110111101
1000000000000000000000000001
1011110110111111110110111101
1011110110111111110110111101
1000000110000110000110000001
1111110111110110111110111111
1111110111110110111110111111
1111110100000000000010111111
1111110101111111111010111111
11111100000E10P0000000111111
1111111101111001111111111111
111111C10000000000001C111111
1111111111111111111111111111
